30 13
1 1 1 1 1 1 1 1 1 1 1 1 1 1 1 1 1 1 1 1 1 1 1 1 1 1 1 1 1 1
1 1 1 1 1 1 1 1 1 1 1 1 1 1 1 1 1 1 1 1 1 1 1 1 1 1 1 1 1 1
1 1 1 1 1 1 1 1 1 1 1 1 1 1 1 1 1 1 1 1 1 1 1 1 1 1 1 1 1 1
1 1 1 1 1 1 1 1 1 1 1 1 1 1 1 1 1 1 1 1 1 1 1 1 1 1 1 1 1 1
1 1 1 1 1 1 1 1 1 1 1 1 1 1 1 1 1 1 1 1 1 1 1 1 1 1 1 1 1 1
1 1 1 1 1 1 8 1 1 1 1 1 1 1 1 1 1 1 1 1 1 1 1 1 1 1 1 1 1 1
1 1 1 1 1 8 8 8 1 1 1 1 1 1 1 1 1 0 0 0 0 1 1 1 1 1 1 1 1 1
1 1 1 1 5 11 4 1 1 1 1 1 1 1 1 0 0 2 2 2 2 0 1 1 1 1 1 1 1 1
1 1 1 1 1 1 7 11 6 1 1 1 1 1 1 0 2 16 2 2 16 2 0 1 1 1 1 1 1 1
9 1 10 1 1 1 7 1 1 1 1 1 1 1 0 2 2 2 2 2 2 2 2 0 1 1 1 1 1 1
0 0 0 0 0 0 0 0 0 14 14 14 14 0 2 2 2 16 2 2 16 2 2 0 0 0 0 0 0 0
2 2 2 2 2 2 2 2 16 15 15 15 15 16 16 2 2 16 16 16 16 2 2 2 2 2 2 2 2 2
16 16 16 16 16 16 16 16 16 16 16 16 16 16 16 16 2 2 2 2 2 2 16 16 16 16 16 16 16 16