20 12
1 1 1 1 1 1 1 1 1 1 1 1 1 1 1 1 1 1 1 1
1 1 1 1 1 1 1 1 1 1 1 1 1 1 1 1 1 1 1 1
1 1 1 1 1 1 1 1 1 1 1 1 1 1 1 1 1 1 1 1
1 1 1 1 1 1 1 1 1 1 1 1 1 1 1 1 1 1 1 1
1 1 1 1 1 1 1 1 1 1 1 1 0 0 1 1 1 1 1 1
1 1 1 1 1 1 1 1 1 1 1 1 1 1 1 1 1 1 1 1
1 1 1 9 9 1 1 1 1 1 1 1 1 1 1 1 1 1 1 1
1 1 1 4 4 1 1 1 1 1 1 1 1 1 1 1 1 1 1 1
1 1 1 7 7 7 7 1 1 1 1 1 1 1 1 1 1 1 1 1
1 1 1 7 7 1 1 8 1 8 1 1 1 1 1 1 1 1 1 1
0 0 0 0 0 0 0 2 2 2 2 2 2 1 1 1 1 1 1 1
0 0 0 0 0 0 0 0 2 2 2 2 2 2 1 1 1 1 1 1