30 30
1 1 1 1 1 1 1 1 1 1 1 1 1 1 1 1 1 1 1 1 1 1 1 1 1 1 1 1 1 1
1 1 1 1 1 1 1 1 1 1 1 1 1 1 1 1 1 1 1 1 1 1 1 1 1 1 1 1 1 1
1 1 1 1 1 1 1 1 1 1 1 1 1 1 1 1 1 1 1 1 1 1 1 1 1 1 1 1 1 1
1 1 1 1 1 1 1 1 1 1 1 1 1 1 1 1 1 1 1 1 1 1 1 1 1 1 1 1 1 1
1 1 1 1 1 1 1 1 1 1 1 1 1 1 1 1 1 1 1 1 1 1 1 1 1 1 1 1 1 1
1 1 1 1 1 1 1 1 1 1 1 1 1 1 1 1 1 1 1 1 1 1 1 1 1 1 1 1 1 1
1 1 1 1 1 1 1 1 1 1 1 1 1 1 1 1 1 1 1 1 1 1 1 1 1 1 1 1 1 1
1 1 1 1 1 1 1 1 1 1 1 1 1 1 1 1 1 1 2 2 16 2 2 16 2 2 2 2 16 16
1 1 1 1 1 1 1 1 1 1 1 1 1 1 1 1 1 1 2 16 16 16 16 16 16 16 16 16 16 16
1 1 1 1 1 1 1 1 1 1 1 1 1 1 1 1 1 1 2 2 2 2 2 16 2 2 2 2 16 2
1 1 1 1 1 1 1 1 1 1 1 1 1 1 1 2 2 2 2 16 2 2 2 2 2 16 2 2 2 16
1 1 1 1 1 1 1 1 1 1 1 1 1 1 2 2 16 16 16 16 16 16 16 16 16 16 16 16 16 16
1 1 1 1 1 1 1 1 1 1 1 1 1 2 2 16 16 16 16 16 16 2 16 16 16 16 16 16 16 16
1 1 1 1 1 1 1 1 1 1 1 1 1 2 2 2 16 16 16 16 16 16 16 16 16 16 2 2 2 16
1 1 1 1 1 1 1 1 1 1 2 2 2 2 2 2 16 16 16 16 2 2 2 2 2 2 2 2 2 2
1 1 1 1 1 1 1 1 1 1 2 16 16 16 2 2 2 2 2 16 2 2 2 2 2 2 2 2 2 2
1 1 1 1 1 1 1 1 1 1 2 16 16 16 16 16 16 16 16 16 2 16 16 2 2 2 2 2 2 16
1 1 1 1 1 1 1 1 1 2 2 16 16 16 16 16 16 16 16 16 16 16 16 16 16 16 16 16 16 16
1 1 1 1 1 1 1 1 2 2 2 2 2 2 2 2 2 2 2 16 16 16 16 16 16 16 16 16 16 16
1 1 1 1 1 1 1 16 16 16 16 16 16 16 16 16 16 16 16 16 16 16 16 16 16 16 16 16 16 16
1 1 1 1 1 1 16 16 16 16 16 16 16 16 16 16 16 16 16 16 16 1 16 1 16 1 16 1 16 1
1 1 1 1 1 1 16 1 16 16 16 16 16 16 16 16 16 16 16 16 16 1 16 1 16 1 16 1 16 1
1 1 1 1 1 1 16 1 16 16 16 16 16 16 16 16 16 16 16 1 1 1 1 1 1 1 1 1 1 1
1 1 1 1 1 16 1 1 1 1 1 1 1 16 1 1 16 1 1 1 1 1 1 1 1 1 1 1 1 1
1 1 1 10 1 1 1 1 1 1 1 1 1 1 1 1 1 1 1 1 1 1 1 1 1 1 1 1 1 1
1 9 2 16 1 1 1 1 1 1 1 1 1 1 1 1 1 1 1 1 1 1 1 1 1 1 1 1 1 1
1 2 16 16 16 16 16 16 16 16 16 16 16 16 16 16 16 16 16 16 16 16 16 16 16 16 16 16 16 16
2 2 2 2 2 2 2 2 2 2 2 2 2 2 2 2 2 2 2 2 2 2 2 2 2 2 2 2 2 2
16 16 16 16 16 16 16 16 16 16 16 16 16 16 16 16 16 16 16 16 16 16 16 16 16 16 16 16 16 16
16 16 16 16 16 16 16 16 16 16 16 16 16 16 16 16 16 16 16 16 16 16 16 16 16 16 16 16 16 16