17 12
1 1 1 1 1 1 1 1 1 1 1 1 1 1 1 1 1
1 3 1 1 1 1 1 1 1 1 1 1 1 1 1 1 1
1 1 1 1 1 1 1 1 1 1 1 1 1 1 1 1 1
1 1 1 1 1 1 1 1 1 1 1 1 1 1 1 1 1
1 1 1 1 1 1 1 1 1 1 1 1 7 7 7 1 1
1 1 1 1 1 1 1 1 1 1 1 7 7 7 7 7 1
1 1 1 1 1 1 1 1 1 1 1 7 7 7 7 7 1
1 1 1 1 1 1 1 1 1 1 1 1 1 6 1 1 1
1 1 1 1 1 1 1 9 1 1 1 1 1 6 1 1 1
1 1 8 1 1 0 0 0 0 1 8 1 1 6 1 9 1
0 0 0 0 0 0 0 0 0 0 0 0 0 0 0 0 0
2 2 2 2 2 2 2 2 2 2 2 2 2 2 2 2 2